
11 30 12 28 15 7 24 15 19 24 12 
6 29 12 5 17 23 30 1 18 31 27 
15 2 28 22 30 27 21 27 30 29 18 
16 14 31 18 31 17 26 18 5 9 26 
14 15 25 14 31 14 18 11 5 29 20 