
0 13 20 21 0 22 17 27 3 15 27 30 5 21 24 15 1 30 25 31 3 9 17 28 27 20 15 26 22 28 6 6 5 7 22 29 1 3 18 12 17 23 22 23 22 15 19 12 4 29 4 
28 22 28 11 28 26 5 13 20 5 3 10 13 16 14 11 24 24 11 26 6 12 12 22 4 4 10 5 26 31 8 14 31 3 28 9 8 27 31 13 27 22 30 4 13 11 30 12 9 7 10 
18 21 20 8 14 3 17 28 26 3 0 14 30 27 4 29 7 1 14 1 5 31 20 20 24 6 2 26 26 2 2 22 3 11 1 17 8 0 27 22 3 7 12 12 16 31 15 5 11 23 8 
10 13 7 9 24 15 4 23 13 2 21 23 6 13 22 3 25 27 23 20 3 8 26 31 9 22 27 1 16 11 29 20 24 16 22 2 14 18 27 18 6 25 0 24 22 13 11 10 24 2 25 
18 16 3 12 7 0 19 26 30 1 29 3 25 24 2 26 18 2 18 31 2 28 16 31 15 24 3 20 18 1 18 15 7 3 10 0 9 23 27 31 16 25 11 21 9 20 28 13 3 6 3 
26 21 13 24 5 25 13 19 0 16 25 6 12 9 19 16 23 26 26 11 29 21 0 31 22 4 8 25 0 14 13 18 15 6 13 11 1 14 31 20 23 27 16 26 13 17 4 13 18 31 26 
11 20 13 14 1 14 13 25 1 20 3 19 22 12 22 19 15 28 4 20 2 23 23 24 7 27 20 9 13 13 13 0 6 14 26 19 15 3 11 22 0 1 2 11 11 15 20 31 3 25 31 
23 8 11 13 22 27 9 24 3 20 7 0 30 29 19 26 25 7 16 14 12 21 22 13 19 2 19 30 9 25 19 26 20 1 17 5 19 8 22 17 10 3 3 16 2 11 17 6 14 2 18 
20 8 1 26 13 0 23 31 0 2 22 11 6 29 31 10 23 3 29 22 17 7 26 23 20 19 9 28 6 15 19 13 25 10 0 3 25 26 17 30 25 28 24 11 1 13 3 30 3 18 30 
21 26 25 1 15 21 16 8 5 30 3 13 6 17 9 8 2 18 9 17 28 31 8 21 9 11 16 3 11 20 9 23 14 1 27 13 26 12 20 14 26 1 4 31 17 10 3 9 3 7 5 
17 2 7 31 27 4 5 29 12 26 18 24 3 5 6 9 18 28 27 0 7 4 31 17 0 27 0 26 3 16 21 16 30 1 11 23 16 29 30 21 8 20 28 5 8 22 29 0 31 9 14 
30 17 20 25 27 16 8 16 14 25 8 25 1 25 29 3 9 16 16 20 23 2 9 18 31 7 25 5 1 19 1 31 2 20 25 31 7 21 21 29 28 25 2 27 4 22 17 6 14 29 21 
25 5 20 0 18 3 13 22 8 8 14 4 25 16 14 2 5 12 1 15 2 14 24 6 8 12 27 13 8 13 17 14 13 20 13 20 1 24 13 2 24 16 4 9 1 20 3 10 28 10 7 
24 10 25 27 6 4 9 30 5 21 12 25 27 3 13 28 3 21 17 6 25 21 14 10 31 6 1 0 20 30 29 13 0 18 13 11 31 29 30 25 27 18 0 27 0 4 20 1 4 20 2 
3 21 5 25 18 4 26 12 11 0 5 26 15 31 17 5 28 24 23 19 17 31 5 1 15 9 20 8 6 8 4 18 6 26 1 15 1 30 5 1 5 2 11 6 23 11 26 14 14 13 10 
22 25 0 17 1 2 26 1 22 16 23 6 14 6 3 3 28 25 27 8 31 22 21 20 23 14 6 14 22 0 4 24 2 5 18 26 7 6 16 10 12 0 4 18 14 27 10 31 25 27 8 
10 4 22 21 2 23 20 31 17 26 3 13 9 31 19 10 7 15 6 3 16 9 1 20 29 5 31 23 30 24 7 27 28 18 9 25 29 29 26 3 16 0 10 20 25 0 5 6 11 28 28 
7 23 1 14 2 30 7 8 30 7 13 3 4 21 15 10 15 19 29 16 17 21 23 1 18 19 2 4 14 16 8 30 9 29 21 11 22 14 30 23 24 12 3 28 23 29 27 15 2 9 10 
6 19 13 7 28 27 25 29 0 0 0 21 7 3 29 23 20 31 10 5 20 5 11 11 6 18 20 24 10 6 5 1 26 14 6 7 29 28 4 0 1 4 24 9 20 23 0 0 12 30 13 
28 18 28 22 31 28 18 26 17 25 17 22 11 15 13 28 30 29 9 20 24 7 13 3 26 4 12 5 17 31 11 23 11 15 1 20 4 11 4 5 14 15 0 4 4 10 17 24 8 14 28 
8 23 19 13 30 18 16 6 4 8 27 18 23 14 27 15 12 28 27 31 23 5 11 1 13 6 14 2 31 28 14 26 21 16 3 21 7 17 14 16 31 21 18 3 1 13 22 11 21 2 23 
12 23 5 21 12 21 2 14 26 14 16 26 25 19 26 15 21 5 13 2 25 23 25 18 31 6 20 11 9 28 11 0 23 25 19 10 11 7 13 21 17 8 2 5 15 18 22 20 22 26 25 
23 5 21 19 28 1 29 24 1 19 3 15 8 8 10 11 10 8 13 16 9 24 31 21 5 22 20 28 19 22 9 28 24 17 6 12 18 16 24 7 0 13 5 24 1 15 3 1 16 3 1 
17 25 1 27 18 27 18 26 7 31 23 6 28 30 26 1 27 1 17 14 29 22 19 13 25 13 20 15 28 28 16 19 18 28 17 18 17 11 18 30 9 4 4 18 3 9 26 21 0 3 18 
16 27 11 17 7 1 13 17 5 28 22 11 25 8 15 7 9 23 3 20 2 12 8 25 11 27 30 9 10 26 1 28 8 30 26 13 0 24 19 21 18 16 22 24 26 20 30 15 14 29 7 
13 0 19 1 27 19 7 6 16 4 16 29 17 20 10 30 7 28 27 10 30 6 11 11 17 11 23 27 0 3 7 22 7 29 13 4 16 13 3 13 28 20 6 23 14 9 11 24 5 23 18 
7 0 10 12 13 1 22 21 27 9 4 14 29 12 4 2 18 30 24 0 13 8 19 2 1 1 19 22 20 2 6 2 8 26 16 24 17 16 15 6 8 25 10 6 27 16 9 31 9 2 2 
17 2 11 12 28 15 14 21 31 13 12 9 11 4 10 4 29 10 19 4 8 26 18 19 17 2 29 5 15 26 26 6 25 25 22 11 26 6 29 17 27 12 28 20 30 17 28 24 25 10 18 
12 18 15 12 28 10 14 1 27 2 23 17 16 12 17 0 13 24 20 24 6 12 5 1 17 6 24 23 22 1 21 4 8 4 2 1 0 12 26 23 0 15 1 0 11 27 20 5 10 21 29 
8 31 5 20 1 8 29 22 17 31 2 30 1 23 31 30 6 31 25 16 7 13 1 2 6 6 25 19 31 19 3 8 19 15 4 10 20 13 8 22 7 7 9 22 22 0 16 14 11 18 10 
24 25 4 22 6 2 3 4 29 23 17 14 13 1 12 8 3 9 3 27 19 21 18 14 2 31 30 18 1 12 29 12 27 22 16 15 26 23 15 21 18 20 16 7 0 14 27 21 20 17 22 
21 4 23 21 17 18 28 11 31 31 7 17 15 2 18 30 30 0 22 21 3 9 23 25 17 16 30 1 22 10 14 9 5 11 10 29 1 17 21 13 24 25 25 12 27 17 15 20 10 25 20 
28 13 5 29 2 4 29 8 0 28 29 16 9 18 5 9 22 4 12 19 21 23 29 24 16 17 20 22 0 4 19 21 27 31 25 10 10 24 22 4 28 17 1 5 5 25 2 11 0 12 24 
5 2 11 13 19 24 15 2 5 11 23 12 7 13 30 15 7 6 14 6 27 8 26 19 9 23 24 11 11 1 13 17 5 16 19 17 29 11 6 27 29 29 4 8 15 22 23 12 15 1 6 
3 22 27 3 30 22 10 3 11 10 14 18 25 19 6 10 13 3 23 12 20 12 20 29 15 16 0 28 5 5 28 31 21 1 16 0 16 1 21 23 2 28 13 5 7 6 16 8 14 0 2 
1 3 12 8 8 18 28 25 25 31 20 15 9 8 29 9 1 29 27 19 29 6 15 20 29 29 9 28 4 24 12 11 2 10 30 12 13 12 17 12 1 27 17 13 28 30 8 28 13 29 24 
30 12 4 31 17 2 11 30 21 4 27 30 3 14 30 11 28 30 12 18 7 23 21 14 22 23 11 20 11 22 19 1 13 11 3 13 18 20 10 18 5 3 24 31 23 26 10 16 5 19 10 
17 11 2 19 24 21 22 16 19 24 29 18 21 26 24 16 12 7 30 28 19 11 20 22 0 8 24 31 19 11 27 1 25 24 19 2 29 17 2 28 31 22 10 1 20 26 23 9 28 31 4 
23 25 27 28 15 10 19 30 13 29 11 19 25 16 17 20 28 13 28 24 29 30 3 9 23 11 13 16 21 10 1 17 8 10 6 24 1 27 4 20 2 6 3 4 15 1 17 2 20 30 18 
0 30 27 26 20 24 3 28 0 11 10 2 12 25 20 0 8 4 6 10 3 8 0 21 7 2 28 17 5 8 14 25 9 21 10 3 26 29 7 11 14 18 24 19 9 4 6 28 26 29 31 
10 30 24 11 12 11 28 2 26 10 20 25 17 15 3 11 24 9 21 6 12 10 0 7 8 10 0 1 2 3 25 25 26 22 25 12 23 10 13 1 16 20 19 24 30 20 31 23 27 6 2 
19 11 11 2 9 15 2 10 26 18 9 17 12 12 12 29 11 17 0 17 10 20 25 7 9 26 7 20 16 29 15 6 7 10 7 20 7 31 9 17 22 13 10 13 3 17 16 21 19 6 18 
24 24 2 25 29 15 9 1 11 6 31 11 12 12 10 6 26 30 2 11 21 30 25 18 30 8 2 0 17 21 28 10 4 2 25 30 0 9 14 26 10 28 11 15 6 6 29 24 0 9 12 
1 6 10 20 30 14 31 3 25 22 12 18 12 4 16 0 13 31 28 29 17 9 6 7 15 9 13 15 21 0 8 1 3 14 14 24 17 25 9 29 13 24 0 30 10 30 14 11 7 3 8 
28 9 17 15 23 1 12 16 16 14 29 28 19 26 5 0 25 18 8 28 20 14 27 0 19 3 22 26 18 19 17 17 31 15 1 10 28 23 9 3 20 29 6 19 17 26 28 28 25 27 25 
22 21 20 25 27 6 28 18 17 18 29 19 20 27 22 19 8 27 12 31 31 16 5 13 24 0 30 16 5 27 16 29 5 25 31 27 16 9 8 29 21 31 31 24 22 18 30 30 19 25 20 
13 8 26 29 14 28 22 8 15 6 21 17 31 9 16 3 3 19 5 15 23 31 11 9 3 22 25 15 23 31 4 3 20 11 11 23 19 6 2 5 6 26 15 12 22 17 30 2 29 17 0 
21 31 18 9 27 20 2 3 8 1 11 9 9 19 11 14 15 12 14 24 1 4 8 29 23 26 18 17 29 15 29 27 30 30 16 13 9 1 26 16 6 3 30 27 29 3 20 8 25 0 30 
3 2 16 11 19 1 5 22 21 9 11 26 21 30 26 0 18 4 25 0 21 5 16 4 8 8 1 18 5 17 24 17 3 15 13 15 11 1 9 21 28 25 10 12 14 11 29 20 26 12 8 
12 23 10 14 19 21 18 30 1 18 9 31 14 12 11 8 0 1 6 29 6 13 6 25 19 13 22 9 16 5 19 27 4 11 15 31 8 29 13 11 31 29 6 0 9 29 11 7 4 30 27 