
3 8 21 29 25 4 7 12 21 30 14 1 8 21 23 27 21 5 12 3 19 25 21 30 22 0 25 2 24 5 10 15 9 1 24 18 3 22 8 26 8 8 9 23 11 27 15 8 21 17 20 
4 13 13 7 30 16 4 27 10 21 5 9 28 3 30 25 2 1 2 1 8 11 1 5 5 5 11 28 12 3 16 19 21 12 19 0 9 24 0 2 6 5 18 31 12 22 28 21 22 3 10 
0 31 1 11 4 25 19 23 27 15 24 29 3 7 5 9 28 20 8 6 27 25 10 18 8 17 24 10 7 9 8 30 13 3 26 31 25 16 17 4 27 9 16 12 2 25 9 30 19 2 9 
10 16 29 17 3 13 17 13 16 28 31 9 16 9 13 0 30 7 15 9 4 18 9 7 12 17 16 2 16 28 8 4 6 3 29 11 17 10 16 6 27 7 6 7 16 3 8 15 21 16 24 
2 13 14 2 20 0 9 10 15 28 7 16 10 22 12 5 20 16 18 28 23 2 28 9 22 23 21 28 23 18 23 18 0 6 2 1 30 15 24 11 29 15 3 2 25 26 18 0 29 19 5 
23 5 20 6 16 14 13 13 2 27 22 25 0 18 21 4 2 2 10 20 23 28 3 3 17 20 1 12 8 21 31 15 25 28 21 4 16 11 20 14 8 24 27 5 15 5 31 15 15 26 9 
16 18 25 24 16 11 8 4 30 12 24 11 25 10 1 19 1 25 0 5 31 8 19 26 16 29 11 2 2 19 18 27 18 3 20 2 30 31 17 27 26 10 0 0 21 16 28 25 31 21 17 
25 20 5 29 12 15 5 23 26 31 17 24 8 11 24 17 22 15 28 16 24 24 28 11 20 20 16 22 18 11 24 25 22 30 23 10 19 5 0 24 20 2 8 28 13 9 10 7 8 24 8 
2 20 7 5 21 13 31 21 14 11 3 19 24 13 9 21 18 2 22 6 6 17 14 24 22 30 10 12 14 16 28 8 10 17 2 22 26 11 25 31 1 22 2 21 13 9 8 26 17 8 17 
29 5 28 0 15 9 16 3 8 3 13 19 28 24 31 8 1 3 29 9 3 13 16 16 13 0 3 26 12 3 0 29 22 5 16 28 28 11 4 22 0 16 3 27 27 17 21 19 5 22 21 
19 0 24 22 26 4 9 5 11 25 10 15 29 30 25 13 22 23 9 26 17 17 24 30 22 29 5 16 26 17 15 0 9 6 1 29 23 31 15 21 20 22 8 15 3 3 23 26 15 3 4 
26 11 8 17 0 6 20 21 16 14 22 4 5 19 16 18 16 0 0 25 16 9 23 28 7 23 3 9 1 29 19 1 20 10 27 9 2 12 9 16 4 31 14 27 21 10 16 17 1 9 18 
12 23 5 0 30 1 12 3 27 21 30 7 24 12 27 4 24 23 12 15 22 31 12 14 2 8 25 19 5 28 5 0 2 17 0 13 23 27 12 11 15 27 24 9 1 15 30 19 17 16 17 
8 14 5 8 18 30 7 8 7 21 15 26 31 8 2 3 26 23 27 6 22 27 24 24 19 4 20 8 1 0 0 19 3 23 9 24 31 1 28 23 29 9 25 26 11 7 4 6 13 31 8 
14 25 22 25 31 4 14 25 9 15 16 1 22 22 14 12 25 15 13 5 11 8 9 7 9 11 7 31 8 9 7 0 12 15 4 18 12 11 12 22 27 13 26 27 12 1 1 12 31 30 26 
6 20 28 7 11 8 6 2 2 8 7 28 0 23 30 6 21 21 21 24 31 25 2 0 31 7 18 9 17 25 0 28 10 29 21 3 21 4 23 30 23 2 9 3 23 21 0 3 26 29 7 
1 4 7 2 14 25 13 13 19 12 27 26 27 14 0 18 11 14 27 8 29 0 20 10 15 29 11 22 11 20 9 22 14 18 0 20 22 20 2 22 7 6 31 22 22 0 6 12 19 22 14 
31 19 22 6 8 1 26 29 6 21 15 18 13 28 17 2 30 7 31 2 1 23 24 17 27 21 15 24 25 1 14 29 9 26 2 3 17 11 24 8 4 29 2 4 7 1 25 14 2 7 19 
29 6 1 2 16 15 12 12 13 1 5 8 16 4 19 3 4 8 9 11 5 31 0 21 26 0 27 30 15 23 29 9 0 13 27 4 1 18 29 12 22 8 30 23 16 30 9 0 0 21 6 
7 2 7 21 15 24 18 22 9 9 18 11 1 28 5 24 17 25 0 8 17 27 22 6 2 8 28 25 15 24 18 18 30 3 10 15 26 27 7 21 11 22 17 4 19 2 4 16 12 9 15 
11 1 17 20 13 17 1 14 29 3 6 23 2 0 28 3 13 11 31 9 14 6 8 9 5 17 30 13 7 10 5 2 31 20 5 15 3 19 22 23 12 19 2 9 18 19 22 1 20 4 18 
3 20 29 4 25 5 7 21 16 22 23 0 27 17 31 10 4 19 6 0 25 11 17 9 15 2 23 21 20 24 10 8 12 1 8 4 12 25 29 4 11 19 13 18 11 21 26 31 25 26 5 
17 1 17 7 10 29 8 31 14 26 12 17 25 29 28 26 7 19 13 14 24 29 14 31 1 5 1 29 30 20 15 6 28 1 28 2 30 31 29 21 10 20 16 21 23 13 27 10 13 29 17 
5 6 8 0 30 7 10 15 12 13 26 21 10 19 31 13 16 14 17 16 12 31 17 27 12 2 4 28 4 7 12 1 22 7 23 1 12 0 19 3 6 11 15 12 30 0 27 24 27 19 19 
0 14 29 20 11 20 27 28 19 29 15 28 7 0 18 22 9 5 12 29 31 16 0 12 28 17 12 27 6 17 27 17 27 19 31 30 31 17 22 28 7 15 30 3 11 23 7 21 24 21 25 
24 5 6 11 7 11 23 31 10 10 26 7 12 24 23 2 2 27 9 27 16 18 11 5 25 16 31 3 23 6 29 24 6 10 11 27 22 17 27 10 24 25 12 0 24 18 31 22 16 0 7 
12 21 10 0 28 25 14 17 9 12 24 17 16 23 2 13 28 14 12 25 28 3 19 14 4 14 9 17 17 22 14 27 12 6 14 26 18 3 21 31 23 13 28 2 24 23 21 0 10 13 22 
9 25 26 9 18 3 2 2 21 12 18 4 1 5 21 27 0 13 2 3 28 5 29 19 15 30 22 21 16 3 16 8 27 0 30 2 5 24 31 31 15 1 13 13 17 21 9 24 25 10 23 
12 23 29 7 13 2 30 30 27 21 10 10 20 24 30 30 1 24 23 13 23 13 24 15 21 26 14 19 13 26 16 13 21 23 15 29 2 24 16 17 4 2 8 17 22 30 27 17 1 10 1 
7 4 30 18 14 9 0 28 6 4 24 30 7 30 6 25 4 11 16 0 21 15 3 1 23 13 9 16 3 10 9 23 10 30 13 11 13 17 4 9 8 15 4 17 2 6 4 9 28 3 13 
9 0 22 1 15 30 26 14 22 16 22 3 5 16 3 16 5 10 2 26 2 12 7 11 26 28 17 25 2 10 28 21 9 20 19 22 22 9 26 16 21 23 15 13 17 10 18 17 26 13 25 
17 7 30 25 24 18 11 6 3 17 6 2 13 11 20 29 2 20 11 3 18 24 27 20 26 23 5 9 30 3 10 6 26 15 21 6 28 6 20 21 13 9 4 26 17 13 1 4 0 14 30 
20 9 28 18 0 27 23 25 18 2 12 30 31 25 17 22 7 6 26 11 1 18 8 31 0 7 7 3 18 9 4 18 3 26 8 12 26 10 8 15 10 28 19 7 13 4 26 2 30 2 19 
23 6 24 25 8 7 26 2 15 24 22 25 17 25 27 3 28 16 24 16 4 23 13 19 20 24 17 24 30 2 6 29 17 15 27 24 19 28 27 12 5 3 23 13 18 11 29 15 6 26 30 
8 12 9 16 1 30 22 20 21 31 27 3 11 2 8 11 13 17 23 13 28 21 9 11 29 23 3 20 18 15 24 7 12 14 11 31 14 14 4 26 14 8 3 6 9 6 1 13 13 28 30 
16 18 18 10 8 22 30 30 11 23 29 15 6 2 15 0 20 29 18 21 28 11 15 22 3 31 11 9 4 15 25 5 21 13 24 16 20 30 4 16 9 2 28 17 24 0 26 23 27 11 23 
22 19 5 11 3 1 3 22 30 8 5 11 24 15 2 9 23 22 31 2 14 18 23 14 30 6 8 23 11 30 10 28 30 23 25 10 29 23 2 22 27 31 13 11 19 15 24 2 7 28 6 
16 22 28 23 11 25 9 14 29 26 3 15 2 29 17 12 27 9 18 28 21 17 31 0 30 20 31 1 31 0 9 4 29 31 1 21 8 22 2 22 13 0 13 16 31 20 0 23 23 11 11 
17 23 27 23 12 31 11 20 5 18 14 10 15 24 31 18 20 30 7 21 4 6 1 22 3 6 21 26 21 8 2 8 3 26 9 11 26 20 23 23 28 1 22 27 17 13 28 27 10 4 16 
12 20 11 22 18 14 14 7 18 17 0 7 24 14 26 6 23 2 17 26 25 1 11 5 16 13 8 25 2 18 23 1 12 10 17 18 22 20 2 7 27 11 13 22 24 21 31 23 21 27 19 
7 5 21 25 0 10 8 29 12 4 23 17 3 9 2 21 22 17 4 25 14 0 18 3 12 11 28 19 2 27 9 0 29 2 4 21 23 24 11 4 14 7 9 24 30 17 21 30 3 10 24 
14 27 24 12 20 22 22 29 6 25 30 31 5 20 3 31 30 14 13 0 20 6 4 19 21 7 9 0 13 12 17 6 18 25 7 15 12 3 8 18 19 0 28 0 0 25 23 22 28 16 10 
9 25 8 9 6 7 12 24 19 8 17 13 23 11 2 22 6 0 28 10 5 2 1 8 6 31 9 0 8 16 26 19 4 26 7 19 0 0 18 15 19 3 26 19 24 24 25 4 29 23 17 
14 17 14 5 7 29 13 16 6 26 18 0 26 18 6 7 29 26 19 12 15 20 7 30 14 21 23 19 10 30 6 20 17 24 11 6 3 13 21 13 4 1 13 17 30 16 15 3 21 13 13 
1 12 29 18 7 23 10 26 4 28 1 3 28 4 8 2 18 12 2 28 18 25 19 7 8 18 6 2 22 29 24 14 25 2 0 4 8 28 1 13 16 21 2 0 13 16 2 29 15 12 23 
4 8 25 20 10 2 28 0 5 27 29 1 23 21 30 13 15 8 6 3 27 11 12 24 21 9 26 24 29 28 6 10 29 22 29 16 3 26 11 3 21 6 12 7 29 29 1 18 4 23 16 
29 13 23 8 19 12 7 15 5 3 30 22 16 24 3 7 9 2 16 23 18 7 27 2 28 14 17 9 3 0 14 16 26 6 9 17 3 16 27 26 4 2 29 5 2 23 27 5 8 10 7 
16 22 12 10 2 3 21 14 9 7 29 8 11 6 21 19 2 30 0 19 15 26 24 9 3 18 19 11 5 11 26 2 28 28 0 5 10 8 15 1 10 29 10 7 0 5 9 13 0 25 20 
28 15 12 14 30 11 12 8 24 24 0 2 9 6 25 30 31 23 27 1 20 5 15 30 6 1 8 24 26 12 20 24 23 18 10 15 26 24 21 31 29 1 17 3 2 6 15 27 3 15 29 
26 27 27 24 18 30 7 14 29 4 27 19 17 13 20 2 4 20 16 22 30 18 17 23 9 17 2 18 11 6 9 23 28 20 6 23 13 31 1 4 15 30 7 29 7 20 31 0 0 21 19 