
15 0 8 4 5 6 15 18 10 31 5 
9 18 10 24 29 31 31 29 14 16 26 
26 13 20 24 29 22 16 1 6 8 19 
3 8 12 6 16 13 24 2 10 0 19 
12 6 1 21 24 5 16 18 23 8 21 
24 24 10 8 4 24 7 2 5 13 21 
6 16 8 27 11 27 10 25 16 8 26 
2 12 21 16 10 13 12 13 24 18 1 
18 1 26 31 8 21 3 24 17 21 16 
22 14 12 25 13 16 16 22 21 22 10 