
29 23 16 12 5 27 24 10 23 12 14 8 12 8 22 20 29 2 3 20 12 17 12 30 19 2 13 16 1 27 0 27 2 4 11 11 15 29 28 10 10 13 6 26 15 5 14 27 26 6 30 
16 11 3 26 10 28 28 14 25 5 11 18 8 18 7 0 8 0 14 24 26 4 7 11 19 30 12 5 13 14 31 2 10 8 28 8 25 29 29 28 5 2 15 12 0 6 31 6 16 4 29 
3 5 19 16 6 30 6 0 9 21 6 22 14 28 10 10 9 26 5 4 27 8 8 13 16 28 19 14 20 25 10 13 12 0 27 20 20 25 26 9 0 3 10 10 18 18 9 28 18 10 15 
9 2 15 26 29 2 26 10 24 8 16 8 17 1 14 30 20 18 11 20 3 9 0 19 21 15 0 28 4 10 5 2 19 11 11 13 24 6 7 14 30 4 3 13 0 11 20 6 29 16 29 
25 18 26 15 27 15 21 11 4 5 19 0 11 2 27 19 13 28 18 8 19 21 25 10 16 21 16 31 22 15 22 18 9 23 3 19 9 30 14 2 25 1 30 9 18 31 7 30 16 22 2 
4 1 3 17 17 5 2 2 12 6 14 29 10 18 17 14 28 28 26 0 24 5 26 29 2 21 6 7 10 12 21 28 27 18 31 5 20 28 4 18 15 21 4 4 19 6 13 25 4 12 11 
7 3 6 9 8 23 13 21 24 9 30 30 20 11 0 3 15 24 23 15 23 25 31 22 4 20 1 21 9 3 17 19 16 18 9 5 30 8 7 12 1 5 18 7 18 4 21 3 10 28 16 
4 19 20 27 17 2 16 11 30 7 2 16 23 6 15 26 4 23 6 4 22 28 12 7 13 8 23 6 14 14 14 21 13 27 2 23 6 8 28 5 28 21 14 18 6 18 7 19 4 17 3 
4 19 9 31 10 3 14 22 25 26 12 26 10 11 14 17 1 20 29 6 2 18 11 5 31 1 26 28 20 27 2 31 31 27 15 0 2 31 10 12 19 7 4 3 14 21 0 2 29 14 19 
23 25 29 14 30 31 27 4 25 4 2 17 31 20 29 19 19 25 10 19 20 2 29 29 11 24 26 12 23 7 8 15 13 27 26 23 30 22 7 25 10 23 25 2 27 9 8 21 7 23 21 
20 27 31 15 12 3 2 12 3 15 31 8 21 11 21 30 19 13 25 26 7 2 0 29 29 29 12 8 4 4 28 28 6 4 30 20 11 3 11 6 4 6 26 6 29 1 9 18 4 22 28 
26 15 15 23 3 12 15 29 23 27 24 25 13 2 11 24 7 27 10 0 20 11 19 17 11 2 8 26 12 4 21 4 25 28 13 10 26 24 22 18 24 28 16 4 13 18 5 6 29 24 1 
11 17 7 11 3 22 3 8 4 7 5 28 14 1 8 17 7 4 17 28 28 3 1 16 26 1 7 20 6 27 17 0 6 15 5 5 4 23 2 10 3 30 7 28 3 30 24 7 24 5 12 
13 26 31 5 10 25 6 27 15 14 28 5 10 27 23 21 28 14 7 25 10 21 23 17 22 21 28 28 26 5 25 28 3 28 16 3 21 5 14 5 4 16 4 27 31 29 10 28 7 5 28 
14 8 0 31 27 9 24 10 27 31 5 6 17 21 10 9 7 30 28 17 23 29 11 1 13 13 31 29 7 6 26 2 29 25 7 8 3 24 11 11 16 25 12 17 6 12 28 7 9 11 10 
28 10 13 9 0 2 29 22 3 9 31 5 31 10 6 31 22 2 7 19 5 1 31 16 3 6 22 4 22 24 18 5 6 14 29 28 19 2 19 2 15 30 27 16 21 24 23 6 2 23 7 
28 25 22 10 18 14 29 2 15 0 28 27 11 5 16 7 9 23 6 29 8 26 31 23 22 27 29 7 16 1 25 16 1 1 1 1 1 30 28 26 11 24 10 3 11 31 3 2 8 11 26 
6 12 19 20 2 9 31 26 26 19 7 27 24 7 20 22 1 9 30 20 6 8 31 12 30 12 24 14 2 21 17 25 23 31 1 18 7 12 11 17 0 22 0 18 1 8 7 31 17 13 9 
6 31 2 24 16 17 13 18 4 4 30 10 30 15 7 13 27 16 29 25 12 29 28 15 31 31 2 11 1 12 24 7 8 13 3 27 14 19 26 12 4 4 5 10 6 29 19 30 9 11 12 
21 29 11 13 30 26 8 13 5 2 15 22 12 18 2 7 24 31 4 14 17 19 23 29 2 14 2 6 30 14 31 27 31 4 5 2 7 21 22 3 27 12 26 24 12 24 26 26 8 24 10 
14 16 4 14 27 12 18 4 26 21 2 0 28 3 4 1 29 0 20 5 21 1 30 25 10 7 16 21 5 0 0 17 17 3 28 6 4 2 9 23 14 2 6 28 0 27 8 24 2 20 4 
0 31 9 8 5 6 23 31 31 7 6 6 23 16 29 13 20 18 22 24 27 2 22 8 17 19 14 27 29 7 8 12 11 17 8 31 1 20 21 19 28 10 22 14 12 28 6 8 7 16 2 
16 18 31 29 11 20 19 15 26 3 16 27 25 7 8 11 22 22 0 28 6 14 11 17 26 12 25 29 4 16 31 8 11 4 11 20 10 26 5 26 6 10 2 27 13 0 11 22 2 10 3 
11 26 20 0 9 27 8 13 5 3 29 21 19 22 12 31 22 17 21 14 22 13 8 8 6 18 16 21 11 16 1 14 5 27 11 1 20 2 30 13 23 24 4 9 3 25 26 19 5 15 23 
13 31 28 14 0 1 20 15 29 17 13 6 5 10 25 26 17 7 0 25 7 29 27 10 26 26 7 9 5 13 12 11 4 28 24 10 1 19 5 3 17 2 9 18 29 27 24 15 13 30 28 
5 1 28 30 31 14 2 30 5 2 1 18 8 9 12 31 15 11 20 19 10 13 15 7 8 31 15 6 29 11 3 0 22 28 18 8 25 19 27 29 9 10 9 21 19 24 23 14 20 8 7 
3 5 2 7 18 9 15 30 13 9 29 3 20 0 10 0 29 1 2 24 30 30 6 2 0 15 17 9 23 4 0 8 0 28 6 21 11 11 1 14 19 11 28 16 8 29 29 27 15 15 24 
1 2 16 9 10 22 26 22 29 4 13 10 27 3 25 27 21 31 30 21 28 4 5 4 15 21 20 19 27 6 13 7 1 11 9 21 25 30 7 9 26 25 12 10 3 12 12 19 7 14 6 
20 31 2 2 10 21 26 19 27 3 16 27 25 30 1 30 26 7 30 29 29 23 0 13 9 30 5 2 23 5 14 18 23 7 9 21 24 30 11 0 11 31 7 31 5 6 17 1 1 12 11 
25 26 2 8 0 20 11 15 20 9 17 19 31 1 16 21 8 29 24 11 1 21 9 30 13 14 17 15 7 13 1 20 13 16 15 20 31 27 26 16 0 24 17 30 10 14 10 31 13 30 17 
19 5 3 15 16 19 26 21 29 21 10 27 2 19 15 1 11 2 8 0 14 18 10 31 10 19 15 12 3 24 13 25 15 16 9 28 23 13 6 18 23 8 9 10 27 28 9 30 31 15 19 
7 13 7 22 3 0 13 18 11 1 4 11 29 15 13 5 1 17 16 5 29 18 24 21 26 11 15 18 5 26 11 2 19 8 2 0 26 29 10 20 8 24 18 29 23 4 5 21 14 9 8 
27 23 13 23 2 9 19 13 10 31 2 14 6 28 12 22 28 5 15 20 13 31 24 16 20 11 15 0 6 27 1 8 10 8 11 18 25 25 26 13 8 25 9 9 25 30 15 15 17 12 27 
13 21 15 29 5 13 24 6 9 31 23 28 2 28 16 11 2 22 13 21 13 24 25 26 2 21 31 20 3 24 20 11 25 2 16 31 12 20 20 19 3 0 1 25 18 5 31 31 2 27 16 
13 11 22 23 29 0 21 25 20 10 27 8 24 17 30 29 23 3 30 5 27 1 20 30 31 10 6 30 17 28 0 31 27 20 4 23 14 7 8 9 7 19 19 27 6 30 25 2 30 18 31 
30 16 3 24 13 16 14 3 4 5 31 31 29 18 23 26 0 26 23 16 31 23 9 0 4 12 29 22 21 0 29 15 31 19 5 31 30 15 30 25 16 23 3 29 17 21 19 8 16 10 27 
23 4 19 8 2 31 9 19 6 13 27 29 7 16 10 28 0 15 21 10 4 24 17 9 27 28 5 11 10 8 24 5 9 30 16 5 8 25 20 1 0 1 9 28 3 22 31 27 10 30 5 
14 6 20 5 12 7 26 7 17 16 28 11 12 10 28 14 13 12 20 17 25 31 21 31 29 4 26 28 1 19 27 6 21 13 10 31 18 28 7 13 18 27 7 6 14 3 4 19 11 24 28 
29 9 11 5 4 17 0 17 30 13 19 12 19 21 31 19 23 21 10 11 31 8 1 20 3 25 25 12 30 8 30 14 19 30 24 3 12 7 6 18 4 8 10 10 17 24 26 12 21 4 18 
22 2 25 5 8 17 25 1 29 23 27 10 16 24 3 15 23 25 0 26 14 8 6 19 9 23 31 8 22 31 22 26 28 14 4 27 7 27 12 25 17 21 23 16 19 1 16 16 30 8 12 
15 0 6 24 30 27 27 15 21 4 7 23 16 30 13 12 4 16 6 19 8 9 8 24 29 5 14 17 16 14 9 30 21 2 17 2 3 6 8 0 6 31 11 4 29 28 21 20 15 9 1 
17 15 15 11 20 21 18 23 0 8 24 6 28 1 17 27 23 27 26 31 30 15 2 10 31 2 1 4 19 6 21 2 29 16 21 25 9 4 4 31 22 27 31 19 3 4 21 10 20 12 25 
20 11 28 16 2 21 20 8 28 3 4 11 9 25 15 11 23 28 11 12 18 23 12 14 18 7 6 9 24 26 4 10 23 21 29 6 4 11 22 6 17 11 22 8 19 0 27 16 25 5 18 
28 11 11 25 24 29 21 28 3 9 11 1 18 1 11 5 15 20 21 1 8 28 12 17 3 31 0 1 11 7 9 22 8 3 28 25 4 3 10 4 19 4 5 29 28 0 9 8 24 11 19 
21 25 29 14 5 15 19 22 10 24 25 9 14 29 6 7 24 12 23 26 24 24 5 15 21 17 21 15 25 7 5 14 1 26 28 20 4 26 26 0 23 16 5 12 29 5 6 22 28 14 14 
9 13 25 9 18 17 7 24 28 19 12 31 11 9 17 11 23 4 25 8 18 6 11 18 10 7 0 11 5 0 15 15 8 21 0 14 17 28 23 16 18 16 28 5 18 10 28 3 9 19 4 
1 20 25 30 20 11 2 26 24 20 28 16 1 28 23 29 25 14 20 28 19 9 2 22 30 13 31 7 0 7 17 6 21 13 0 30 27 21 29 24 6 14 30 15 2 1 31 5 25 24 15 
24 30 11 31 8 16 31 1 7 13 19 30 8 14 27 17 1 27 23 20 22 23 30 2 0 13 23 20 8 31 31 18 20 1 8 13 6 29 11 13 29 3 6 13 0 28 18 15 3 3 0 
16 12 16 9 3 3 22 13 8 9 24 17 26 24 7 6 4 25 9 3 19 22 5 25 30 18 5 25 27 8 25 15 29 27 5 13 6 1 1 3 0 8 22 9 29 21 15 4 2 26 20 
0 30 30 10 20 31 9 28 13 22 17 0 28 5 7 6 2 25 2 18 27 29 30 29 5 10 28 20 16 17 8 8 19 15 5 21 1 31 4 14 3 9 21 24 23 0 16 0 27 2 11 