
25 25 6 23 16 10 27 28 27 25 1 2 26 9 26 17 25 24 21 4 22 31 19 18 31 23 5 2 26 3 0 14 2 5 13 21 21 12 30 4 22 18 27 0 14 1 30 19 16 0 4 
5 7 14 10 27 20 28 10 20 31 12 26 31 5 26 9 25 3 6 27 10 4 7 7 3 9 5 5 16 11 7 25 2 2 0 17 22 4 19 18 13 31 24 17 19 25 23 17 5 24 27 
22 14 2 19 20 0 6 16 27 25 27 5 8 9 28 29 19 5 8 3 17 28 19 6 13 2 7 7 14 29 18 23 3 22 11 29 6 26 19 31 17 20 28 29 29 29 8 17 12 2 1 
30 10 5 11 14 4 2 7 5 6 10 14 18 19 4 11 29 7 23 30 23 16 20 29 28 0 30 16 20 21 5 29 24 11 11 28 17 25 5 18 16 20 12 4 4 18 6 11 5 17 31 
18 19 17 24 23 16 1 15 2 27 17 4 17 28 30 5 31 9 4 25 28 23 7 9 12 7 29 28 1 26 6 2 26 3 6 3 11 16 13 23 14 13 25 29 31 3 20 21 17 11 17 
12 0 4 24 0 20 27 27 11 8 26 15 10 26 10 0 22 10 29 16 22 6 25 28 23 8 19 23 31 1 30 31 13 17 19 5 17 7 17 7 29 10 6 10 19 21 18 12 11 24 9 
31 28 4 25 0 16 28 1 17 21 9 2 15 30 28 31 3 12 29 13 11 11 11 11 28 19 2 20 30 11 15 13 8 26 16 6 19 26 9 20 13 31 1 30 27 27 31 9 2 13 0 
27 26 28 3 31 10 25 25 16 2 23 5 23 21 6 1 14 8 30 30 25 27 12 7 5 0 4 4 22 14 1 23 15 30 30 13 15 7 31 30 5 9 15 25 21 2 29 19 15 0 20 
16 2 5 21 11 28 31 2 24 15 10 24 9 31 18 14 10 12 24 17 29 16 24 27 23 3 10 13 0 18 5 26 25 12 3 6 17 16 30 2 4 5 7 10 9 14 19 14 5 7 2 
22 15 18 19 16 20 14 3 6 10 31 5 17 8 8 23 5 23 17 10 18 15 13 1 28 7 9 5 21 10 20 15 28 29 10 2 9 6 15 11 9 29 24 4 27 21 27 13 22 11 1 
23 25 31 5 6 14 0 1 29 16 4 24 10 7 8 16 8 13 21 30 10 2 24 19 29 24 30 11 24 17 8 27 22 7 12 22 26 13 21 14 13 7 25 0 29 8 29 28 26 21 24 
15 11 20 22 22 25 5 18 10 10 10 20 13 2 0 18 11 23 21 20 2 27 19 17 16 8 31 19 0 29 0 5 21 4 31 10 14 7 3 13 10 31 15 6 11 9 23 22 29 29 10 
2 8 23 4 3 20 2 22 31 3 16 24 9 23 7 18 21 19 25 28 25 23 17 8 20 23 19 11 8 14 0 28 14 30 7 27 13 18 31 6 2 30 18 1 20 29 23 7 22 11 17 
5 31 10 17 4 5 2 27 0 2 27 31 2 16 8 24 13 26 14 12 12 1 8 22 14 5 19 21 28 3 10 25 14 7 21 11 8 25 24 27 8 13 0 16 26 3 27 29 16 11 28 
20 14 7 23 9 20 31 29 26 1 2 25 20 22 28 20 29 14 31 20 13 7 4 25 25 13 19 27 3 12 1 30 28 9 31 6 0 28 7 25 3 18 26 3 0 11 26 28 20 20 10 
8 0 25 13 8 9 0 11 30 29 4 24 27 10 13 23 31 0 23 18 10 20 2 11 31 0 29 4 13 0 24 19 8 28 29 4 0 1 24 22 11 15 22 6 29 23 14 15 0 1 7 
16 22 5 17 25 0 8 20 13 23 31 27 18 5 31 3 13 0 10 4 24 24 5 14 13 17 16 19 14 25 30 11 6 23 10 8 21 6 4 14 28 8 16 12 13 13 6 0 21 29 13 
7 27 20 17 14 16 16 13 17 14 20 4 3 0 17 16 7 5 17 0 0 0 31 0 12 2 23 13 13 24 28 9 9 13 12 11 2 28 24 7 30 15 15 30 20 9 6 19 13 30 31 
12 22 13 25 27 23 11 19 28 12 1 1 16 9 16 31 8 24 26 14 9 25 26 27 4 13 1 17 4 11 28 24 17 26 0 29 24 31 4 14 0 13 6 17 26 9 3 27 22 13 11 
18 16 3 31 16 14 4 3 10 25 30 30 13 4 30 19 7 13 1 18 31 5 23 5 9 2 20 29 10 2 31 0 23 29 21 6 8 15 13 22 14 2 13 2 7 4 5 25 29 4 27 
0 21 11 21 1 6 16 6 12 5 29 17 10 22 8 4 4 3 15 28 31 29 29 10 26 19 2 29 17 31 20 10 4 31 8 29 22 26 9 18 7 22 13 0 9 1 10 23 29 22 30 
3 12 15 28 13 27 17 6 8 0 30 1 17 14 6 22 29 10 9 29 28 12 19 13 13 19 28 7 2 28 30 1 18 13 3 25 8 20 1 30 15 5 20 27 31 24 15 6 29 24 7 
12 25 22 1 17 6 11 3 16 30 16 9 10 4 12 18 8 16 19 23 25 16 16 12 24 24 8 19 26 28 19 28 2 1 2 23 5 14 15 20 20 17 27 6 28 22 12 23 20 28 26 
2 12 23 17 21 1 10 21 31 16 0 21 31 0 5 23 12 27 19 24 10 7 8 2 22 26 7 5 4 21 27 24 26 13 16 23 23 8 19 25 23 5 17 1 28 5 7 31 26 28 21 
16 19 17 2 1 9 19 17 2 18 10 11 7 24 12 7 23 25 4 29 11 10 4 24 19 12 1 0 29 15 23 16 1 10 3 1 28 18 9 10 28 7 14 27 21 27 25 30 7 24 19 
25 12 10 21 21 6 8 17 5 1 1 25 27 22 15 25 25 25 11 19 9 14 30 9 6 6 27 22 4 4 31 12 17 0 3 17 21 25 10 28 25 24 12 19 11 31 13 31 19 27 16 
31 16 20 10 3 1 31 30 16 5 22 5 19 0 6 6 24 18 16 12 24 15 17 8 2 31 1 24 29 1 23 10 7 28 1 3 20 9 6 13 9 29 21 14 5 17 10 3 11 10 28 
4 7 15 25 12 19 21 10 20 11 1 23 4 23 21 1 16 2 4 20 11 0 18 2 31 31 26 2 2 11 20 30 0 14 8 30 18 24 0 19 29 31 20 16 10 8 8 20 5 19 24 
1 19 6 24 4 25 9 15 18 10 10 10 8 7 3 30 24 1 17 10 7 1 18 21 27 3 7 21 25 21 0 8 14 9 19 28 14 3 13 7 20 0 1 29 21 28 14 18 19 20 3 
28 7 13 29 15 23 7 21 12 14 2 28 29 30 8 15 29 13 6 13 31 1 30 23 19 17 0 1 25 14 7 7 16 10 2 22 0 30 12 2 26 9 15 10 27 9 4 25 1 6 15 
14 25 12 25 12 27 27 17 5 18 2 26 2 0 13 20 16 31 13 23 22 6 4 16 2 20 17 26 17 21 10 30 3 6 9 8 19 7 9 2 21 31 25 9 7 23 19 25 5 31 12 
25 4 6 24 2 22 11 28 21 6 11 13 30 31 2 5 14 14 0 19 13 15 11 16 16 26 8 24 13 14 12 14 9 11 18 25 19 10 25 31 24 26 3 13 22 2 19 9 31 16 26 
24 2 4 17 22 4 19 12 7 17 5 24 29 7 10 0 3 5 5 1 19 10 19 15 28 29 21 1 14 25 15 8 29 14 0 4 16 8 20 11 8 13 23 21 20 25 31 9 0 16 24 
27 11 17 0 17 31 26 9 8 12 31 1 29 16 28 27 29 5 24 23 24 29 24 14 10 27 14 7 23 11 7 4 9 22 13 22 31 30 25 9 3 10 21 2 27 7 3 19 24 8 19 
2 22 17 10 16 26 11 9 5 28 19 3 15 21 11 31 26 12 4 20 11 26 1 0 6 14 28 20 12 2 28 0 13 25 30 28 31 11 12 18 1 22 20 5 9 24 30 19 29 21 4 
2 27 20 28 26 19 23 28 21 15 12 9 31 3 18 12 12 25 16 7 7 10 29 11 17 24 28 26 22 25 11 30 20 3 0 3 4 4 12 9 13 18 16 17 18 17 17 18 6 20 30 
14 21 25 29 18 22 3 17 7 17 30 15 2 8 12 21 24 28 16 25 12 8 1 8 18 20 9 18 30 3 16 21 10 4 29 2 2 29 17 11 1 22 16 0 26 9 29 25 12 14 13 
25 23 13 12 11 13 8 9 16 30 8 10 31 26 18 29 17 27 20 29 22 5 3 22 23 1 23 15 16 15 15 2 9 21 4 29 28 7 30 26 11 20 8 15 28 11 14 20 9 18 29 
4 4 2 11 24 21 12 8 8 9 5 0 15 16 10 22 21 23 6 29 8 20 2 17 2 22 15 3 28 13 13 25 27 25 29 12 14 12 6 12 9 30 30 30 24 20 31 30 1 10 15 
4 30 7 11 28 3 3 13 14 26 9 19 11 0 29 11 14 12 28 28 11 13 31 8 23 12 22 21 18 10 22 2 22 18 27 16 3 12 12 2 4 6 22 1 20 3 18 4 21 27 6 
23 8 25 18 6 15 29 19 13 12 0 9 13 18 22 4 25 21 18 22 13 4 22 28 26 29 20 16 29 6 0 20 11 12 24 9 29 1 20 11 27 10 29 26 4 26 3 10 25 15 9 
19 25 15 14 24 17 5 14 7 28 15 8 18 30 5 25 19 15 17 16 28 3 4 19 18 4 20 20 16 19 7 10 3 17 28 30 6 30 24 3 9 2 24 3 5 13 30 13 10 9 13 
5 23 2 20 9 1 16 12 28 3 13 16 23 5 28 11 25 22 2 13 15 3 6 21 16 28 13 25 26 7 14 3 9 26 20 28 15 21 0 31 8 27 2 13 2 9 30 4 25 18 12 
0 16 28 30 27 6 13 23 31 28 7 24 17 0 2 7 6 15 7 13 21 24 1 31 18 28 30 19 29 8 8 13 4 23 15 22 28 15 23 27 23 8 17 25 10 24 6 3 20 21 13 
28 18 21 14 11 12 8 8 8 5 23 24 26 25 6 25 21 4 23 2 20 0 25 13 19 16 17 0 18 11 10 23 15 14 9 7 4 4 1 13 9 13 12 19 3 2 16 12 29 27 17 
30 6 16 2 5 4 8 8 28 31 21 8 1 14 24 2 24 6 25 28 27 16 9 4 2 18 27 7 10 31 12 5 29 13 30 0 4 7 30 31 11 24 22 16 6 27 30 12 24 9 4 
16 3 31 24 24 1 5 10 14 19 12 25 17 4 17 24 23 23 30 5 5 19 23 24 11 9 17 17 4 27 4 9 22 24 31 21 26 9 5 15 17 24 17 10 5 27 6 13 18 29 1 
11 0 18 3 28 14 22 23 7 0 30 1 0 12 5 18 25 12 9 3 24 23 17 22 28 14 13 31 18 6 18 21 24 19 14 12 16 6 29 2 8 14 1 26 17 15 14 25 16 11 2 
6 31 5 22 18 11 19 8 26 30 11 0 19 11 28 13 17 30 1 6 9 16 8 3 3 13 8 15 21 24 17 29 1 31 8 1 22 7 1 19 0 9 26 5 28 22 15 4 24 29 31 
19 31 1 21 12 17 15 28 11 23 7 25 14 13 20 8 6 18 30 12 18 4 6 15 7 12 8 16 18 28 5 26 28 22 4 7 13 8 7 23 24 12 19 20 23 4 0 5 22 31 29 